W;W;W;W;W;W;W;W;W;W;W;W;W;W;W;W;W;W;W;W;W;W;W;W;W
W;N;W;G;N;N;N;N;W;N;N;N;W;N;N;N;W;N;N;N;N;N;W;N;W
W;N;W;W;N;W;N;N;N;N;W;N;W;N;W;N;N;N;N;W;N;W;W;N;W
W;N;W;N;N;W;W;W;W;W;W;N;W;N;W;W;W;W;W;W;B;N;W;N;W
W;N;N;N;W;W;N;N;N;N;W;N;W;N;W;N;N;N;N;W;W;N;N;N;W
W;N;W;N;N;W;N;W;W;W;W;W;W;W;W;W;W;W;N;W;N;N;W;N;W
W;N;W;W;N;W;N;W;N;N;N;N;N;N;N;N;N;W;N;W;N;W;W;N;W
W;N;W;N;N;N;N;N;N;W;W;W;W;W;W;W;N;N;N;N;N;N;W;N;W
W;N;W;W;W;W;N;W;N;W;G;N;N;N;N;W;N;W;N;W;W;W;W;N;W
W;N;W;N;N;W;N;W;N;W;N;W;W;W;N;W;N;W;N;W;N;N;W;N;W
W;N;W;W;N;W;N;W;N;W;N;N;N;N;N;W;N;W;N;W;N;W;W;N;W
W;N;N;N;N;W;N;W;N;W;N;W;N;W;N;W;N;W;N;W;N;N;N;N;W
W;W;W;W;N;W;W;W;N;N;N;W;N;W;N;N;N;W;W;W;N;W;W;W;W
W;N;N;N;N;W;N;W;N;W;N;W;N;W;N;W;N;W;N;W;N;N;N;N;W
W;N;W;W;N;W;N;W;N;W;N;N;N;N;N;W;N;W;N;W;N;W;W;N;W
W;N;W;N;N;W;N;W;N;W;N;W;W;W;N;W;N;W;N;W;N;N;W;N;W
W;N;W;W;W;W;N;W;N;W;N;N;N;N;P;W;N;W;N;W;W;W;W;N;W
W;N;W;N;N;N;N;N;N;W;W;W;W;W;W;W;N;N;N;N;N;N;W;N;W
W;N;W;W;N;W;N;W;N;N;N;N;N;N;N;N;N;W;N;W;N;W;W;P;W
W;N;W;N;N;W;N;W;W;W;W;W;W;W;W;W;W;W;N;W;N;N;W;N;W
W;N;N;N;W;W;N;N;N;N;W;N;W;B;W;N;N;N;N;W;W;N;N;N;W
W;N;W;N;N;W;W;W;W;W;W;N;W;N;W;W;W;W;W;W;N;N;W;N;W
W;N;W;W;N;W;N;N;N;N;W;N;W;N;W;N;N;N;N;W;N;W;W;N;W
W;N;W;G;N;N;N;N;W;N;N;N;W;N;N;N;W;N;N;N;N;N;W;N;W
W;W;W;W;W;W;W;W;W;W;W;W;W;W;W;W;W;W;W;W;W;W;W;W;W
;;;;;;;;;;;;;;;;;;;;;;;;
1;2;3;4;5;6;7;8;9;10;11;12;13;14;15;16;17;18;19;20;21;22;23;24;25
